------
*特性：<audio> 标签用于定义声音，比如音乐或其他音频流。
    对比H4代码：HTML5:<audio src="someaudio.wav">您的浏览器不支持 audio 标签。</audio>
                 HTML4:<object type="application/ogg" data="someaudio.wav"><param name="src" value="someaudio.wav"></object>
    对于兼容此代码的浏览器，播放时不再需要插件的存在，Internet Explorer 9+, Firefox, Opera, Chrome 以及 Safari 支持 <audio> 标签
*属性与方法： 新属性    属性值
    autoplay 	autoplay 	如果出现该属性，则音频在就绪后马上播放。
    controls 	controls 	如果出现该属性，则向用户显示控件，比如播放按钮。
    loop 	     loop 	  如果出现该属性，则每当音频结束时重新开始播放。
    muted 	   muted 	  规定视频输出应该被静音。
    preload 	preload   如果出现该属性，则音频在页面加载时进行加载，并预备播放。如果使用 "autoplay"，则忽略该属性。
    src 	      url 	  要播放的音频的 URL。
    同时许多事件能够响应
    abort 	当音频/视频的加载已放弃时
    canplay 	当浏览器可以播放音频/视频时
    canplaythrough 	当浏览器可在不因缓冲而停顿的情况下进行播放时
    durationchange 	当音频/视频的时长已更改时
    emptied 	当目前的播放列表为空时
    ended 	当目前的播放列表已结束时
    error 	当在音频/视频加载期间发生错误时
    loadeddata 	当浏览器已加载音频/视频的当前帧时
    loadedmetadata 	当浏览器已加载音频/视频的元数据时
    loadstart 	当浏览器开始查找音频/视频时
    pause 	当音频/视频已暂停时
    play 	当音频/视频已开始或不再暂停时
    playing 	当音频/视频在已因缓冲而暂停或停止后已就绪时
    progress 	当浏览器正在下载音频/视频时
    ratechange 	当音频/视频的播放速度已更改时
    seeked 	当用户已移动/跳跃到音频/视频中的新位置时
    seeking 	当用户开始移动/跳跃到音频/视频中的新位置时
    stalled 	当浏览器尝试获取媒体数据，但数据不可用时
    suspend 	当浏览器刻意不获取媒体数据时
    timeupdate 	当目前的播放位置已更改时
    volumechange 	当音量已更改时
    waiting 	当视频由于需要缓冲下一帧而停止
------
安全性：对于这个新出来的声效标签，安全漏洞和之前h4的img和object类似，都是可以外部获取url内嵌攻击代码；
        不过对于之前的攻击方式大多都会被short和medisity(忘了怎么拼了）的规则限制住，无法生效；
        但对于新标签的利用，可以根据浏览器的插件与兼容性上入手！
        同时对于新标签的新增事件响应，也有许多反射型XSS的植入点。
------
